.....................
RH....%...R.....COLOR
Ta......@.G......TEMP
Tr......@.B..........
Pr........Pa.........
lat.......lon........
IR........alt........
VIS..................
UVI.......RawIR......
UVA.........VIS......
UVB........dark......
......X.....Y.....Z..
Acc..................
Mag..................
Gyr..................
.....................
